BXXXXXXXXXXXXXXXXXXXXXXXXXXX_XXB
BXXXXXXXXXXXXXXXXXXXXXXXXXXX_XXB
BXXXXXXXXXXXXXXXXXXXXXXXXXXX_XXB
BXXXXXXXXXXXXXXXXXXXXXXXXXXX_XXB
BXXXXXXXXXXXXXXXXXXXXXXXXXXX_XXB
BXXXXXXXXXXXXXXXXXXXXXXXXXXX_XXB
BXXXXXXXXXXXXXXXXXXXXXXXXXXX_XXB
BXXXXXXXXXXXXXXXXXXXXXXXXXXX_XXB
BXXXXXXXXXXXXXXXXXXXXXXXXXXX_XXB
BXXXXXXXXXXXXXXXXXXXXXXXXXXX_XXB
BXXXXXXXXXXXXXXXXXXXXXXXXXXX_XXB
BXXXXXXXXXXXXXXXXXXXXXXXXXXX_XXB
BXXXXXXXXXXXXXXXXXXXXXXXXXXX_XXB
_______________________________B
BXXXXXXXXXXXX_XXXXXXXXXXXXXXXXXB
BXXXXXXXXXXXX_XXXXXXXXXXXXXXXXXB
BXXXXXXXXXXXX_XXXXXXXXXXXXXXXXXB
BXXXXXXXXXXXX_XXXXXXXXXXXXXXXXXB
BXXXXXXXXXXXX_XXXXXXXXXXXXXXXXXB
BXXXXXXXXXXXX_XXXXXXXXXXXXXXXXXB
BXXXXXXXXXXXX_XXXXXXXXXXXXXXXXXB
BXXXXXXXXXXXX_XXXXXXXXXXXXXXXXXB
B______________________________B
BBBBBBBBBBBBBBBBBBBBBBBBBBBBBBBB