.....#....................#.....
.....#....................#.....
.....#....................#.....
.....#....................#.....
.....#....................#.....
.....#....................#.....
.....#....................#.....
.....#....X...............#.....
.....#....................#.....
.....#....................#.....
.....#....................#.....
.....#....................#.....
.....#....................#.....
.....#..X.................#.....
.....#....................#.....
.....#................X...#.....
.....#....................#.....
.....#......X.............#.....
.....#....................#.....
.....#....................#.....
.....#....................#.....
.....#....................#.....
.....#....................#.....
.....######################.....