B______________________________B
B______________________________B
B__________________X___________B
B_______X_______________X______B
B______________________________B
B_______________X______________B
B___X__________________________B
B_______________________X______B
B____X______X__________________B
B______________________________B
B___________X__________________B
B______________________________B
B______________X_______________B
B______________________________B
B______________________________B
B____X________________X________B
B______________________________B
B______________X_______________B
B________X_____________________B
B____________________X____X____B
B______________________________B
B______________________________B
B______________________________B
BBBBBBBBBBBBBBBBBBBBBBBBBBBBBBBB
